        ##@ 
 ########   
  # #   ### 
@## # #     
  #  ### ## 
 ####  #  # 
 #  ####### 
            